1111111111111111111111111111111111111111111111111111111111111111111111111111111111111111111111111111
1000000000000000000000000000000000000000000000000000000000000000000000000000000000000000000000000001
1000000000000000000000000000000000000000000000000000000000000000000000000000000000000000000000000001
1000000000000000000000000000000000000000000000000C000000000000000000000000000000000P0000000000000001
1C00000000000000000000000000000C000000000000000000000000000000C0000000000000000000000000000000000001
1000000000000000000000000000000000000000000000000000000000000000000000000000000000111111111111111101
1000000000000000000000000000000C00000000011111111111111111111111100000000000000000000000000000000001
1000000000110000000000000000000000000000000000000000000000000000000000000000001100000000000000000001
100000000000000000000000000000000000000000000000000000000000E000000000000000000000000000000000000001
1000000000000000000000000000000000000000000000000000000000000000000000000000000000000000000000000001
100000000000000C000000000000000000000000000000000000000000000000000000000000000000000000000000000001
1111111111111111111111111111111111111111111111111111111111111111111111111111111111111111111111111111
