1111111111111111111111111111111
1000000000001000000000000000001
1P00000000010000000000000000001
1000000000010000000000000000001
10000000000000000000000000000111
1C00000000010000000000000C00011
10000000C0010000000000C00000001
10000000E00100000000000000000011
1111111111111111111111111111111
