1111111111111101111111111111111
1000000000001000000000000000001
1P00000000010000000000000000001
1000000000010000000000000000000
1000000000000000000000000000011
1C00000000010000000000000C00011
10000000C0010000000000C00000001
10000000E001000000000000000000C
1111111111111111110111111111111
